1111111111111111
1E0010C000C0C111
100C001000111111
10PC10C0000CCC11
1111111111111111